.o..xxxxx.o.........
...oxxxxx...........
....xxxxx...........
....xxxxxo.o........
....xxxxx...o...o...
.o..o..oo.o.........
...........o.....o..
.o...o.........o....
...............o..o.
....o............o..
..o..o..o....o......
......o..o.....o..o.
.o...o...o...o......
...o..........o.....
..................o.
...........o....oo..
........o...........
...o....o.....o...oo
...........o........
